................................
.XXXXXXXXXXXXXXX.....XXXXXXXXXX.
.X.....X.......X.....X........X.
.X.....X.......XXXXXXX........X.
.XXXXXXXXXXXX.................X.
.X....X.....X.................X.
.X....X.....XXXX..............X.
.XXXXXX........X..............X.
......X........X..............X.
......X........X..............X.
......X........X..............X.
......XXXXXXXXXXXXXXXXXXXXXXXXX.
................................
